###########
#T.......T#
#.KKKKKKK.#
#.K.K.K.K.#
#.........#
#KK.K.K.KK#
#...KKK...#
#.K.....K.#
#.@..B....#
###########