#######
#@....####
#...#...#.#
#######...#
#......##.#
#.##.#....#
#.#..##.#.#
#.#.##.#.##
#.......##
.#.....##
.#######