...#######
.........##
.#######.##
###.......#
#...#######
###.......#
..#######.#
.#........#
.#.########
.#......@##
.#########