###########
#T.......T#
#.KKKKK...#
#KK.......#
#...KKKKKK#
#KK.......#
#..KKKKK..#
#.@.......#
#....B....#
###########