###########
#T....KK.T#
#...K.....#
#KKKKK.K..#
#......KK.#
#.KK.K....#
#.K..KK.K.#
#.K.KK.K.K#
#..@.B..KK#
###########
